8 10
1 1 1 1 1 1 1 1
1 0 0 0 2 2 5 1
1 0 2 0 0 2 0 0
2 0 0 2 0 0 0 2
2 0 3 0 2 0 0 1
2 2 0 2 1 3 0 1
0 2 0 1 1 0 0 1
1 1 4 0 1 0 2 2
0 2 2 0 0 0 0 1
0 0 0 0 0 2 2 2